AOI = "countries/AOI - Africa Orientale Italiana.txt"
BFR = "countries/BFR - Baikal Federal Republic.txt"
DVR = "countries/DVR - Far Eastern Republic.txt"
PGG = "countries/GER - General-Government.txt"
RKA = "countries/GER - RKA_Nordland.txt"
RKB = "countries/GER - RKB_Belgium.txt"
RKD = "countries/GER - RKD_Don-Wolga.txt"
RKH = "countries/GER - RKH_Holland.txt"
RKK = "countries/GER - RKK_Kaucasus.txt"
RKM = "countries/GER - RKM_Moskowien.txt"
RKN = "countries/GER - RKN_Norwegen.txt"
RKO = "countries/GER - RKO_Ostland.txt"
RKS = "countries/GER - RKS_Sweden.txt"
RKT = "countries/GER - RKT_Turkestan.txt"
RKU = "countries/GER - RKU_Ukraine.txt"
RKV = "countries/GER - RKV_WestSiberia.txt"
RKW = "countries/GER - RKW_Westgebiet.txt"
HNN = "countries/HNN - Hunan.txt"
KUR = "countries/KUR - Kurdistan.txt"
NBK = "countries/NBK - England.txt"
SIC = "countries/SIC - Sichuan.txt"
SNZ = "countries/SNZ - Siberian Neutral Zone.txt"
YAK = "countries/YAK - Yakut National State.txt"
RUS = "countries/Russia.txt"
DPR = "countries/North Korea.txt"
CZR = "countries/Czech Republic.txt"
ELD = "countries/England.txt"
ERI	= "countries/Eritrea.txt"
SOM	= "countries/Somalia.txt"
VLA = "countries/Vlaanderen.txt"
WLL	= "countries/Wallonia.txt"
LIE = "countries/Liechtenstein.txt"
MCO = "countries/Monaco.txt"
ADR = "countries/Andorra.txt"
SMR = "countries/San Marino.txt"
VCT = "countries/Vatican.txt"
SAR = "countries/Saar.txt"
GRL = "countries/Greenland.txt"
RSI = "countries/RSI - Italian Social Republic.txt"
GNM = "countries/GNM - German North America.txt"
JPS = "countries/JPS - Japanese Pacific States.txt"
NEU = "countries/NEU - Neutral Zone.txt"
